1 13 31
###############################
#p     *1 *    *   *  * * *   #
# # # #*# # #*#*# # # #*#*#*# #
#         ***  *      *   * * #
# # # # # #*# # #*#*# # # # #*#
#f           **  *  *         #
# # # # # # # # # #*# #*# # # #
#*  *      *  *      *        #
# # # # #*# # # #*#*# # # # # #
#*    **  *       *        2  #
# #*# # # # # # #*# # # # #1# #
#           *   *  *     2 x  #
###############################
